#########################################################################
#           ######   ####          #      #                ##############
#                    ####          #      #     ####            ####    #
#     ###         ####             #      #     ####                    #
#     ###         ####             #      #     ####      ###           #
#     ###         ####             ###   ##               ###           #
#                    #                    #                             #
#                    #                    #                  #######    #
#######   ############                    #############   ###############
#                    #                         #                #########
#          ####      #       #####             #                        #
###        ####      #       #####             #                       ##
###                          #####                          #####      ##
###                                                         #####      ##
#                    #                         #            #####      ##
#        ########    #          ##########     ########                 #
#########################################################################